一伙	一伙
一并	一併
一准	一准
一划	一划
一台	一台
一地里	一地裡
一干	一干
一树百获	一樹百穫
一冲	一衝
一只	一隻
一发千钧	一髮千鈞
一出	一齣
七只	七隻
三元里	三元裡
三台	三台
三国志	三國誌
三复	三複
三只	三隻
上台	上台
上吊	上吊
下不了台	下不了台
下台	下台
下馀	下餘
下面	下麵
不下于	不下於
不准	不准
不吊	不吊
不同于	不同於
不屑于	不屑於
不干	不幹
不舍	不捨
不知所云	不知所云
不绝于耳	不絕於耳
不致于	不致於
不良于行	不良於行
不识台举	不識檯舉
不逊于	不遜於
不锈钢	不鏽鋼
丑剧	丑劇
丑旦	丑旦
丑角	丑角
世界杯	世界盃
并存着	並存著
并于	並於
中台医专	中台醫專
中岳	中嶽
丰南	丰南
丰台	丰台
丰姿	丰姿
丰神俊朗	丰神俊朗
丰采	丰采
丰韵	丰韻
主席台	主席台
主干	主幹
主控台	主控台
主播台	主播台
之于	之於
九世之雠	九世之讎
九只	九隻
干丝	乾絲
干着急	乾著急
干面	乾麵
乱发	亂髮
云云	云云
云何	云何
云尔	云爾
互于	互於
五台	五台
五岳	五嶽
五斗柜	五斗櫃
五斗橱	五斗櫥
五斗米	五斗米
五谷	五穀
五行生克	五行生剋
五只	五隻
五出	五齣
井台	井台
井里	井裡
亚于	亞於
交卷	交卷
交于	交於
交游	交遊
亦于	亦於
亭台	亭台
人云亦云	人云亦云
人物志	人物誌
什锦面	什錦麵
什么	什麼
仆倒	仆倒
仇雠	仇讎
介系词	介係詞
介于	介於
介系词	介繫詞
以致于	以致於
任凭	任憑
任教于	任教於
仿制	仿製
伙伕	伙伕
伙伴	伙伴
伙同	伙同
伙夫	伙夫
伙房	伙房
伙计	伙計
伙食	伙食
伴游	伴遊
但凭	但憑
布下	佈下
布告	佈告
布哨	佈哨
布局	佈局
布岗	佈崗
布施	佈施
布景	佈景
布有	佈有
布满	佈滿
布线	佈線
布置	佈置
布署	佈署
布道	佈道
布达	佈達
布防	佈防
布阵	佈陣
布雷	佈雷
位于	位於
低于	低於
体育锻鍊	体育鍛鍊
何干	何干
作准	作准
作奸犯科	作姦犯科
佣人	佣人
佣工	佣工
佣金	佣金
并入	併入
并列	併列
并到	併到
并合	併合
并吞	併吞
并在	併在
并成	併成
并排	併排
并拢	併攏
并案	併案
并为	併為
并发	併發
并科	併科
并购	併購
并进	併進
来台	來台
来自于	來自於
来复	來複
供制	供製
依凭	依憑
依附于	依附於
侵并	侵併
便于	便於
便辟	便辟
系数	係數
系为	係為
保险柜	保險柜
信号台	信號台
修复	修複
修胡刀	修鬍刀
俯冲	俯衝
个里	個裡
倒台	倒台
倒绷孩儿	倒繃孩兒
借着	借著
倦游	倦遊
偃仆	偃仆
假力于人	假力於人
假发	假髮
偏于	偏於
停制	停製
侦听台	偵聽台
偷鸡不着	偷雞不著
备注	備註
家伙	傢伙
家俱	傢俱
家具	傢具
传布	傳佈
债台高筑	債台高築
傻里傻气	傻裡傻氣
倾向于	傾向於
倾复	傾複
倾复	傾覆
僱佣	僱佣
仪表	儀錶
亿只	億隻
尽尽	儘儘
尽先	儘先
尽其所有	儘其所有
尽力	儘力
尽可能	儘可能
尽快	儘快
尽早	儘早
尽是	儘是
尽管	儘管
尽速	儘速
尽量	儘量
优于	優於
优游	優遊
允准	允准
充饥	充饑
先于	先於
光采	光采
克里	克裡
克复	克複
免于	免於
入伙	入伙
内制	內製
全台	全台
全凭	全憑
两台	兩台
两只	兩隻
八台	八台
八字胡	八字鬍
八只	八隻
公布	公佈
公干	公幹
公斗	公斗
公历	公曆
公里	公裡
公诸于世	公諸於世
六谷	六穀
六只	六隻
六出	六齣
兼并	兼併
兼并	兼并
册卷	冊卷
再于	再於
冤雠	冤讎
冶游	冶遊
准予	准予
准假	准假
准定	准定
准将	准將
准尉	准尉
准此	准此
准考证	准考證
准许	准許
几几	几几
几杖	几杖
几案	几案
几筵	几筵
几丝	几絲
凡于	凡於
凹洞里	凹洞裡
出征	出征
出于	出於
出自于	出自於
出游	出遊
函复	函覆
刀削面	刀削麵
刁斗	刁斗
分布	分佈
切面	切麵
刊布	刊佈
划上	划上
划下	划下
划不来	划不來
划了	划了
划具	划具
划出	划出
划到	划到
划动	划動
划去	划去
划子	划子
划得来	划得來
划拳	划拳
划桨	划槳
划水	划水
划算	划算
划船	划船
划艇	划艇
划着	划著
划着走	划著走
划行	划行
划走	划走
划起	划起
划进	划進
划过	划過
初征	初征
别于	別於
别致	別緻
别着	別著
别只	別隻
利于	利於
利比里亚	利比裡亞
刮着	刮著
刮胡刀	刮鬍刀
刻于	刻於
剃发	剃髮
剃须	剃鬚
削发	削髮
克制	剋制
克扣	剋扣
克日	剋日
克星	剋星
克服	剋服
克期	剋期
克死	剋死
克薄	剋薄
前仆后仰	前仆後仰
前仆后继	前仆後繼
前台	前台
前车之复	前車之覆
刚才	剛纔
剥制	剝製
剪发	剪髮
割舍	割捨
创获	創穫
创制	創製
力争上游	力爭上遊
加害于	加害於
加于	加於
加里宁	加裡寧
加注	加註
助于	助於
勇于	勇於
胜于	勝於
劳力士表	勞力士錶
勿施于人	勿施於人
包准	包准
包谷	包穀
匏系	匏繫
化妆台	化妝台
北岳	北嶽
北斗	北斗
北回	北迴
匡复	匡複
匪干	匪幹
十卷	十卷
十台	十台
十干	十干
十只	十隻
十出	十齣
千百只	千百隻
千丝万缕	千絲萬縷
千回百折	千迴百折
千回百转	千迴百轉
千钧一发	千鈞一髮
千只	千隻
升斗小民	升斗小民
半只	半隻
南台	南台
南岳	南嶽
南征	南征
南斗	南斗
南回	南迴
南游	南遊
卡里	卡裡
印制	印製
卷入	卷入
卷取	卷取
卷土重来	卷土重來
卷子	卷子
卷宗	卷宗
卷尺	卷尺
卷层云	卷層雲
卷帙	卷帙
卷扬机	卷揚機
卷曲	卷曲
卷染	卷染
卷烟	卷煙
卷筒	卷筒
卷纬	卷緯
卷绕	卷繞
卷舌	卷舌
卷装	卷裝
卷轴	卷軸
卷云	卷雲
卷领	卷領
卷发	卷髮
卷须	卷鬚
厚朴	厚朴
原于	原於
参与	參与
参与者	參与者
参合	參合
参考价值	參考價值
参与	參與
参与人员	參與人員
参与制	參與制
参与感	參與感
参与者	參與者
参观团	參觀團
参观团体	參觀團體
参阅	參閱
及于	及於
友台	友台
反于	反於
反冲	反衝
反复	反複
反复	反覆
取信于	取信於
取舍	取捨
取材于	取材於
取决于	取決於
取法于	取法於
受制于	受制於
受阻于	受阻於
口里	口裡
口说无凭	口說無憑
古柯咸	古柯鹹
另于	另於
只准	只准
只凭	只憑
只冲	只衝
叮当	叮噹
可怜虫	可憐虫
可于	可於
可紧可松	可緊可鬆
台上	台上
台下	台下
台中	台中
台光	台光
台前	台前
台北	台北
台南	台南
台命	台命
台商	台商
台启	台啟
台地	台地
台基	台基
台塑	台塑
台大	台大
台子	台子
台安	台安
台尺	台尺
台州	台州
台布	台布
台币	台幣
台式	台式
台后	台後
台拉维夫	台拉維夫
台斤	台斤
台新银行	台新銀行
台东	台東
台柱	台柱
台机路	台機路
台步	台步
台汽	台汽
台泥	台泥
台海	台海
台澎	台澎
台湾	台灣
台照	台照
台灯	台燈
台独	台獨
台玻	台玻
台球	台球
台甫	台甫
台省	台省
台端	台端
台糖	台糖
台肥	台肥
台胞	台胞
台航	台航
台菜	台菜
台裔	台裔
台装	台裝
台制	台製
台西	台西
台视	台視
台览	台覽
台词	台詞
台语	台語
台资	台資
台车	台車
台辅	台輔
台金	台金
台银	台銀
台衔	台銜
台铝	台鋁
台铁	台鐵
台鉴	台鑒
台阶	台階
台电	台電
台风	台風
台驾	台駕
台凤	台鳳
司令台	司令台
吁吁	吁吁
吁气	吁氣
吃着不尽	吃著不盡
吃里扒外	吃裡扒外
吃里爬外	吃裡爬外
各吊	各吊
各凭	各憑
合伙	合伙
合并	合併
合并	合并
合于	合於
合着	合著
合着者	合著者
吊上	吊上
吊下	吊下
吊了	吊了
吊个	吊個
吊儿郎当	吊兒郎當
吊到	吊到
吊去	吊去
吊取	吊取
吊吊	吊吊
吊嗓	吊嗓
吊好	吊好
吊子	吊子
吊带	吊帶
吊带裤	吊帶褲
吊床	吊床
吊得	吊得
吊挂	吊掛
吊挂着	吊掛著
吊杆	吊杆
吊架	吊架
吊桶	吊桶
吊杆	吊桿
吊桥	吊橋
吊死	吊死
吊灯	吊燈
吊环	吊環
吊盘	吊盤
吊索	吊索
吊着	吊著
吊装	吊裝
吊裤	吊褲
吊裤带	吊褲帶
吊袜	吊襪
吊走	吊走
吊起	吊起
吊车	吊車
吊钩	吊鉤
吊销	吊銷
吊钟	吊鐘
同伙	同伙
名闻于世	名聞於世
名表	名錶
后冠	后冠
后北街	后北街
后土	后土
后妃	后妃
后安路	后安路
后平路	后平路
后座	后座
后稷	后稷
后羿	后羿
后街	后街
后里	后里
向着	向著
吝于	吝於
吞并	吞併
吟游	吟遊
吹发	吹髮
吕后	呂后
呆里呆气	呆裡呆氣
呈准	呈准
周而复始	周而複始
周游	周遊
呼吁	呼吁
和奸	和姦
和面	和麵
哪里	哪裡
哭脏	哭髒
唱游	唱遊
问卷	問卷
问政于民	問政於民
问道于盲	問道於盲
善于	善於
喝采	喝采
乔岳	喬嶽
单干	單干
单凭	單憑
单于	單於
单只	單隻
嘴里	嘴裏
嘴里	嘴裡
恶心	噁心
当啷	噹啷
当当	噹噹
噜苏	嚕囌
向导	嚮導
向往	嚮往
向应	嚮應
向日	嚮日
向迩	嚮邇
严丝合缝	嚴絲合縫
严复	嚴複
囉苏	囉囌
四舍五入	四捨五入
四号台	四號台
四只	四隻
四出	四齣
回台	回台
回历新年	回曆新年
回丝	回絲
回着	回著
回复	回覆
回游	回遊
回采	回采
困于	困於
固于	固於
囿于一时	囿於一時
囿于一隅	囿於一隅
囿于成见	囿於成見
圈子里	圈子裡
圈里	圈裡
国历	國曆
国雠	國讎
园里	園裡
园游会	園遊會
圆台	圓台
图里	圖裡
土里	土裡
土制	土製
在台	在台
在于	在於
地志	地誌
坑里	坑裡
垂直于	垂直於
垂发	垂髮
垮台	垮台
埃及豔后	埃及豔后
埃荣冲	埃榮衝
埋布	埋佈
城里	城裡
基干	基幹
基于	基於
报复	報複
塌台	塌台
塔台	塔台
涂着	塗著
墓志	墓誌
墨斗	墨斗
墨沈未干	墨瀋未乾
墨索里尼	墨索裡尼
垦复	墾複
坛台	壇台
压卷	壓卷
垄断价格	壟斷價格
垄断资产	壟斷資產
垄断集团	壟斷集團
壮游	壯遊
壶里	壺裡
寿面	壽麵
夏天里	夏天裡
夏历	夏曆
外制	外製
多台	多台
多于	多於
多冲	多衝
多采多姿	多采多姿
多么	多麼
夜光表	夜光錶
夜里	夜裡
夜游	夜遊
梦里	夢裡
梦游	夢遊
大伙	大伙
大卷	大卷
大干	大干
大干	大幹
大于	大於
大夸	大誇
大辟	大辟
大只	大隻
天台	天台
天后	天后
天干	天干
天文台	天文台
天翻地复	天翻地覆
太后	太后
失信于人	失信於人
失于	失於
奏折	奏摺
奏于	奏於
女丑	女丑
女佣	女佣
好家夥	好傢夥
好凭	好憑
好戏连台	好戲連台
好困	好睏
如于	如於
如饥似渴	如饑似渴
始于	始於
委罪于人	委罪於人
姜丝	姜絲
奸夫	姦夫
奸妇	姦婦
奸宄	姦宄
奸情	姦情
奸杀	姦殺
奸污	姦汙
奸污	姦污
奸淫	姦淫
奸猾	姦猾
奸细	姦細
奸邪	姦邪
嫁于	嫁於
嫁祸于人	嫁禍於人
娴于	嫻於
嬉游	嬉遊
字汇	字彙
字里行间	字裡行間
存折	存摺
存于	存於
宇宙志	宇宙誌
安于	安於
安沈铁路	安瀋鐵路
定准	定准
定于	定於
定制	定製
定都于	定都於
宜于	宜於
宣布	宣佈
宦游	宦遊
宫里	宮裡
宴游	宴遊
家伙	家伙
家里	家裏
家里	家裡
寄于	寄於
密布	密佈
密致	密緻
寇雠	寇讎
富于	富於
寓兵于农	寓兵於農
寓情于景	寓情於景
寓教于乐	寓教於樂
寓于	寓於
寓禁于征	寓禁於征
寓禁于征	寓禁於徵
实干	實幹
写字台	寫字台
写字台	寫字檯
宽松	寬鬆
宝卷	寶卷
宝里宝气	寶裡寶氣
封后	封后
封面里	封面裡
射干	射干
将于	將於
专美于前	專美於前
专注	專註
对台	對台
对于	對於
对表	對錶
导游	導遊
小丑	小丑
小伙	小伙
小于	小於
小只	小隻
少吊	少吊
少于	少於
就凭	就憑
就于	就於
就里	就裡
就读于	就讀於
尺布斗粟	尺布斗粟
尼克松	尼克鬆
尼采	尼采
尿斗	尿斗
局里	局裡
居于	居於
居里	居裡
屈服于	屈服於
屋子里	屋子裡
屋里	屋裡
展布	展佈
展卷	展卷
屡仆屡起	屢仆屢起
属意于	屬意於
属于	屬於
屯里	屯裡
山岳	山嶽
山斗	山斗
山里	山裡
山重水复	山重水複
岱岳	岱嶽
峰回	峰迴
岳岳	嶽嶽
巅复	巔覆
巡回	巡迴
巡游	巡遊
工作台	工作台
工于	工於
巧干	巧幹
已于	已於
巴尔干	巴爾幹
巴里	巴裡
巷里	巷裡
市里	市裡
布谷	布穀
希腊	希腊
帘子	帘子
帘布	帘布
席卷	席卷
带团参加	帶團參加
带发修行	帶髮修行
干世	干世
干休	干休
干系	干係
干冒	干冒
干卿何事	干卿何事
干卿底事	干卿底事
干城	干城
干将	干將
干德道	干德道
干戈	干戈
干挠	干撓
干扰	干擾
干支	干支
干政	干政
干时	干時
干没	干沒
干涉	干涉
干犯	干犯
干禄	干祿
干与	干與
干着急	干著急
干诺道中	干諾道中
干诺道西	干諾道西
干谒	干謁
干证	干證
干誉	干譽
干贝	干貝
干连	干連
干云蔽日	干雲蔽日
干预	干預
平台	平台
平衡台	平衡台
年历	年曆
年里	年裡
并力	并力
并吞	并吞
并日而食	并日而食
并行	并行
干上	幹上
干下去	幹下去
干不了	幹不了
干不成	幹不成
干了	幹了
干事	幹事
干些	幹些
干个	幹個
干劲	幹勁
干员	幹員
干啥	幹啥
干吗	幹嗎
干嘛	幹嘛
干坏事	幹壞事
干完	幹完
干将	幹將
干得	幹得
干性油	幹性油
干才	幹才
干掉	幹掉
干校	幹校
干活	幹活
干流	幹流
干球温度	幹球溫度
干略	幹略
干线	幹線
干练	幹練
干警	幹警
干起来	幹起來
干路	幹路
干办	幹辦
干这一行	幹這一行
干这种事	幹這種事
干道	幹道
干部	幹部
干么	幹麼
几台	幾台
几于	幾於
几丝	幾絲
几只	幾隻
几出	幾齣
底里	底裡
店里	店裡
府台	府台
康采恩	康采恩
庙台	廟台
庙里	廟裡
广播台	廣播台
建台	建台
建都于	建都於
弄脏	弄髒
弔卷	弔卷
弘历	弘曆
强奸	強姦
强干弱枝	強幹弱枝
别扭	彆扭
别拗	彆拗
别气	彆氣
别脚	彆腳
别着	彆著
弹子台	彈子檯
弹珠台	彈珠檯
弹药	彈葯
汇刊	彙刊
汇报	彙報
汇整	彙整
汇算	彙算
汇编	彙編
汇总	彙總
汇纂	彙纂
汇辑	彙輯
汇集	彙集
形单影只	形單影隻
形于	形於
影后	影后
役于外物	役於外物
往来于	往來於
往里	往裡
往复	往複
征伐	征伐
征兵	征兵
征利	征利
征尘	征塵
征夫	征夫
征属	征屬
征帆	征帆
征戌	征戌
征战	征戰
征收	征收
征服	征服
征求	征求
征发	征發
征衣	征衣
征讨	征討
征途	征途
后台	後台
后于	後於
得于	得於
徜徉于	徜徉於
从事于	從事於
从里到外	從裡到外
从里向外	從裡向外
御史台	御史台
复雠	復讎
复辟	復辟
德干高原	德干高原
心愿	心愿
心里	心裏
心里	心裡
志于	志於
忙于	忙於
忙里	忙裡
忠于	忠於
快干	快幹
快冲	快衝
怎么	怎麼
怎么着	怎麼著
急于	急於
急冲而下	急衝而下
怪里怪气	怪裡怪氣
怯于	怯於
恩准	恩准
息交绝游	息交絕遊
悠游	悠遊
情报台	情報台
情有所钟	情有所鍾
情有独钟	情有獨鍾
意面	意麵
感于	感於
愧于	愧於
慌里慌张	慌裡慌張
惯于	慣於
慰借	慰藉
忧郁	憂郁
凭仗	憑仗
凭你	憑你
凭依	憑依
凭信	憑信
凭借	憑借
凭吊	憑吊
凭单	憑單
凭弔	憑弔
凭恃	憑恃
凭据	憑據
凭栏	憑欄
凭眺	憑眺
凭票	憑票
凭空	憑空
凭良心	憑良心
凭着	憑著
凭借	憑藉
凭借着	憑藉著
凭虚御风	憑虛御風
凭証	憑証
凭证	憑證
凭靠	憑靠
凭高	憑高
蒙懂	懞懂
懒于	懶於
怀里	懷裡
怀表	懷錶
悬吊	懸吊
悬心吊胆	懸心吊膽
惧于	懼於
或于	或於
戏台	戲台
戴表	戴錶
戽斗	戽斗
房里	房裡
手不释卷	手不釋卷
手卷	手卷
手折	手摺
手术台	手術台
手里	手裏
手里	手裡
手表	手錶
手松	手鬆
才干	才幹
才高八斗	才高八斗
打印台	打印台
打谷	打穀
扞御	扞禦
批准	批准
批复	批複
批复	批覆
批注	批註
承制	承製
抓奸	抓姦
抗御	抗禦
折冲	折衝
披复	披覆
披发	披髮
抱朴	抱朴
抵台	抵台
抵御	抵禦
拆伙	拆伙
拆台	拆台
拈须	拈鬚
拉纤	拉縴
拉面	拉麵
拖吊	拖吊
拗别	拗彆
拘泥于	拘泥於
拙于	拙於
拮据	拮据
拳击台	拳擊台
十沈	拾瀋
指挥台	指揮台
挑台	挑台
捉奸	捉姦
捍御	捍禦
舍不得	捨不得
舍出	捨出
舍去	捨去
舍命	捨命
舍己从人	捨己從人
舍己救人	捨己救人
舍己为人	捨己為人
舍己为公	捨己為公
舍己为国	捨己為國
舍得	捨得
舍我其谁	捨我其誰
舍本逐末	捨本逐末
舍弃	捨棄
舍死忘生	捨死忘生
舍生	捨生
舍短取长	捨短取長
舍身	捨身
舍车保帅	捨車保帥
舍近求远	捨近求遠
捲发	捲髮
捵面	捵麵
掌柜	掌柜
排骨面	排骨麵
挂帘	掛帘
挂面	掛麵
接着说	接著說
控制台	控制台
掩卷	掩卷
提心吊胆	提心吊膽
插图卷	插圖卷
插足于	插足於
换台	換台
换吊	換吊
换只	換隻
换发	換髮
握发	握髮
搭伙	搭伙
折合	摺合
折奏	摺奏
折子	摺子
折尺	摺尺
折扇	摺扇
折梯	摺梯
折椅	摺椅
折叠	摺疊
折痕	摺痕
折篷	摺篷
折纸	摺紙
折裙	摺裙
撒布	撒佈
撚须	撚鬚
撞球台	撞球檯
擂台	擂台
擅于	擅於
操作台	操作台
操纵台	操縱台
担仔面	擔仔麵
担担面	擔擔麵
担着	擔著
担负着	擔負著
据云	據云
挤身于	擠身於
擢发难数	擢髮難數
拟准	擬准
拟于	擬於
摆布	擺佈
摄于	攝於
摄制	攝製
支干	支幹
收获	收穫
改于	改於
改制	改製
攻克	攻剋
放松	放鬆
故布疑阵	故佈疑陣
故于	故於
败于垂成	敗於垂成
叙说着	敘說著
敢于	敢於
散伙	散伙
散布	散佈
散发	散髮
整台	整台
整只	整隻
整出	整齣
敌忾同雠	敵愾同讎
文凭	文憑
文借	文藉
文采	文采
斗亚兰路	斗亞蘭路
斗六	斗六
斗南	斗南
斗大	斗大
斗子	斗子
斗室	斗室
斗宿	斗宿
斗方	斗方
斗栱	斗栱
斗笠	斗笠
斗筲	斗筲
斗箕	斗箕
斗篷	斗篷
斗胆	斗膽
斗蓬	斗蓬
斗转参横	斗轉參橫
斗量	斗量
斗门	斗門
料斗	料斗
斤斗	斤斗
斯里兰卡	斯裡蘭卡
新历	新曆
断头台	斷頭台
断发文身	斷髮文身
方才	方纔
方志	方誌
于七	於七
于事无补	於事無補
于今	於今
于左	於左
于幼华	於幼華
于心何忍	於心何忍
于思	於思
于戏	於戲
于斯	於斯
于于	於於
于是	於是
于此	於此
于法无据	於法無據
于焉	於焉
于田	於田
于飞	於飛
施舍	施捨
旁注	旁註
旅游	旅遊
旋绕着	旋繞著
旋回	旋迴
族里	族裡
日历	日曆
日志	日誌
日进斗金	日進斗金
早于	早於
明台家商	明台家商
明于	明於
明了	明瞭
明窗净几	明窗淨几
明里	明裡
易于	易於
星斗	星斗
星历	星曆
星移斗换	星移斗換
星移斗转	星移斗轉
星罗棋布	星羅棋佈
星辰表	星辰錶
春假里	春假裡
春天里	春天裡
春游	春遊
昧于	昧於
景致	景緻
暗地里	暗地裡
暗沟里	暗溝裡
暗里	暗裡
畅游	暢遊
暂于	暫於
暴敛横征	暴斂橫征
暴虎凭河	暴虎憑河
历数	曆數
历书	曆書
历法	曆法
历象	曆象
书卷	書卷
曾于	曾於
会干	會幹
会于	會於
会里	會裡
月台	月台
月历	月曆
有害于	有害於
有凭有据	有憑有據
有损于	有損於
有求于人	有求於人
有益于	有益於
有只	有隻
服务台	服務台
服务于	服務於
服从于	服從於
木制	木製
本台	本台
朴子	朴子
朴实	朴實
朴忠	朴忠
朴直	朴直
朴硝	朴硝
朴素	朴素
朴茂	朴茂
朴资茅斯	朴資茅斯
朴钝	朴鈍
材干	材幹
村里	村裡
杜老志道	杜老誌道
束修	束脩
束发	束髮
杯面	杯麵
东岳	東嶽
东征	東征
东游	東遊
松赞干布	松贊干布
板着脸	板著臉
枕借	枕藉
林宏岳	林宏嶽
果于	果於
枝干	枝幹
枯干	枯幹
某只	某隻
染发	染髮
柜上	柜上
柜台	柜台
柜子	柜子
柜柳	柜柳
查卷	查卷
查号台	查號台
查询台	查詢台
校雠学	校讎學
核准	核准
核复	核覆
格里	格裡
案准	案准
案卷	案卷
条干	條幹
梯冲	梯衝
械系	械繫
梳妆台	梳妝台
棉卷	棉卷
棉制	棉製
棱台	棱台
栖于	棲於
植发	植髮
乐意于	樂意於
乐于	樂於
楼台	樓台
标志着	標志著
标致	標緻
标注	標註
标志	標誌
模制	模製
树干	樹幹
树干	樹榦
桥台	橋台
横征暴敛	橫征暴斂
横冲	橫衝
档卷	檔卷
检复	檢覆
台子	檯子
台布	檯布
台灯	檯燈
台球	檯球
台面	檯面
柜台	櫃台
柜台	櫃檯
栏干	欄干
次于	次於
欷吁	欷吁
欺蒙	欺矇
歌后	歌后
欧几里得	歐幾裡得
欧游	歐遊
止于	止於
正于	正於
正当着	正當著
此仆彼起	此仆彼起
武后	武后
武松	武鬆
归并	歸併
归功于	歸功於
归咎于	歸咎於
归因于	歸因於
归于	歸於
归罪于	歸罪於
归随于	歸隨於
归顺于	歸順於
死于	死於
死里求生	死裡求生
死里逃生	死裡逃生
残卷	殘卷
杀虫药	殺虫藥
壳里	殼裡
毁于	毀於
母后	母后
每台	每台
每于	每於
每只	每隻
比干	比干
毛卷	毛卷
毛坏	毛坏
毛发	毛髮
毫发	毫髮
气冲斗牛	氣沖斗牛
气冲牛斗	氣沖牛斗
气象台	氣象台
水斗	水斗
水里	水裡
水表	水錶
永历	永曆
永志不忘	永誌不忘
求教于	求教於
污蔑	汙衊
江干	江干
池里	池裡
污蔑	污衊
汲汲于	汲汲於
沃台公司	沃台公司
沈着	沈著
沉湎于	沉湎於
沉溺于	沉溺於
沉迷于	沉迷於
沉醉于	沉醉於
没事干	沒事幹
没精打采	沒精打采
冲着	沖著
沙里淘金	沙裡淘金
河岳	河嶽
河里	河裡
油面	油麵
泛游	泛遊
泡制	泡製
泡面	泡麵
泰斗	泰斗
洄游	洄遊
洗发	洗髮
活动于	活動於
派团参加	派團參加
流于	流於
流理台	流理台
流行于	流行於
浪琴表	浪琴錶
浪游	浪遊
浮台	浮台
浮吊	浮吊
浮于	浮於
浮夸	浮誇
浮游	浮遊
海里	海裡
浸于	浸於
涂着	涂著
涉足于	涉足於
液晶表	液晶錶
凉台	涼台
凉面	涼麵
淡朱	淡硃
深于	深於
渊淳岳峙	淵淳嶽峙
渠冲	渠衝
测验卷	測驗卷
港台	港台
港制	港製
凑合着	湊合著
湖里	湖裡
汤团	湯糰
汤面	湯麵
源于	源於
溢于言表	溢於言表
温郁	溫郁
溶于	溶於
卤制	滷製
卤面	滷麵
满布	滿佈
满于	滿於
漏斗	漏斗
漫游	漫遊
潜意识里	潛意識裡
潭里	潭裡
溃于蚁穴	潰於蟻穴
激于	激於
浓于	濃於
浓郁	濃郁
浓发	濃髮
湿地松	濕地鬆
蒙蒙	濛濛
蒙雾	濛霧
蒙鸿	濛鴻
沈海	瀋海
沈阳	瀋陽
濒于	瀕於
瀛台	瀛台
弥漫	瀰漫
弥漫着	瀰漫著
灌于	灌於
漓江	灕江
火并	火併
灰蒙	灰濛
炒面	炒麵
炮台	炮台
炮制	炮製
炸药	炸葯
炸酱面	炸醬麵
为凭	為憑
为着	為著
乌干达	烏干達
乌苏里江	烏蘇裡江
乌发	烏髮
乌龙面	烏龍麵
烘制	烘製
烽火台	烽火台
无动于衷	無動於衷
无干	無干
无凭无据	無憑無據
无损于	無損於
无济于事	無濟於事
无畏于	無畏於
无益于事	無益於事
无精打采	無精打采
无补于事	無補於事
无视于	無視於
炼制	煉製
烟卷儿	煙卷兒
烟台	煙台
烟斗	煙斗
烟斗丝	煙斗絲
照准	照准
熔于	熔於
熨斗	熨斗
热衷于	熱衷於
灯台	燈台
燎发	燎髮
燕游	燕遊
烫发	燙髮
烫面	燙麵
烛台	燭台
爆吁	爆吁
炉台	爐台
墙里	牆裡
片言只语	片言隻語
牛肉面	牛肉麵
牛只	牛隻
特准	特准
特征	特征
特于	特於
特里	特裡
特制	特製
牵系	牽繫
犯台	犯台
狃于成见	狃於成見
狼借	狼藉
猛冲	猛衝
奖杯	獎盃
获准	獲准
率团参加	率團參加
王侯后	王侯后
王台	王台
王后	王后
班里	班裡
球台	球台
理发	理髮
环游	環遊
甘于	甘於
甚于	甚於
甚么	甚麼
甜面酱	甜麵醬
生力面	生力麵
生于	生於
生姜	生薑
生锈	生鏽
生发	生髮
产于	產於
用于	用於
田里	田裡
由馀	由余
由于	由於
由表及里	由表及裡
男佣	男佣
男用表	男用錶
留发	留髮
畚斗	畚斗
划卷	畫卷
划着	畫著
异于	異於
当于	當於
当着	當著
疏于	疏於
疏松	疏鬆
疑系	疑係
疲于奔命	疲於奔命
疲困	疲睏
病症	病癥
症候	癥候
症状	癥狀
症结	癥結
登台	登台
发布	發佈
发射台	發射台
发于	發於
发蒙	發矇
发着	發著
发面	發麵
发霉	發黴
白卷	白卷
白干儿	白干兒
白里透红	白裡透紅
白发	白髮
白面	白麵
百谷	百穀
百里	百裡
百只	百隻
皇后	皇后
皇历	皇曆
皓发	皓髮
皮里阳秋	皮裏陽秋
皮里春秋	皮裡春秋
皮制	皮製
皱折	皺摺
盒里	盒裡
盛行于	盛行於
监制	監製
盘里	盤裡
盘回	盤迴
直接参与	直接參与
直冲	直衝
相克	相剋
相同于	相同於
相干	相干
相冲	相衝
看台	看台
真凭实据	真憑實據
眺望台	眺望台
眼帘	眼帘
眼眶里	眼眶裡
眼里	眼裡
困乏	睏乏
困倦	睏倦
睡着了	睡著了
睡游病	睡遊病
了如	瞭如
了望	瞭望
了然	瞭然
了若指掌	瞭若指掌
了解	瞭解
瞳蒙	瞳矇
蒙住	矇住
蒙昧无知	矇昧無知
蒙混	矇混
蒙蒙	矇矇
蒙眬	矇矓
蒙蔽	矇蔽
蒙骗	矇騙
矜夸	矜誇
短发	短髮
矮几	矮几
石台	石台
石英表	石英錶
石莼	石蓴
研制	研製
砰当	砰噹
砲台	砲台
朱唇皓齿	硃唇皓齒
朱批	硃批
朱砂	硃砂
朱笔	硃筆
朱红色	硃紅色
朱色	硃色
朱谕	硃諭
硬干	硬幹
砚台	硯台
碑志	碑誌
磁制	磁製
磨制	磨製
碍于	礙於
示复	示覆
社里	社裡
祝英台	祝英台
神台	神台
神游	神遊
神采	神采
祭台	祭台
御侮	禦侮
御寇	禦寇
御寒	禦寒
御敌	禦敵
礼台	禮台
礼义干橹	禮義干櫓
秃发	禿髮
秀斗	秀斗
秀发	秀髮
私下里	私下裡
秋天里	秋天裡
秋裤	秋褲
秒表	秒錶
稀松	稀鬆
禀复	稟覆
稻谷	稻穀
稽征	稽征
谷人	穀人
谷保家商	穀保家商
谷仓	穀倉
谷场	穀場
谷子	穀子
谷梁	穀梁
谷壳	穀殼
谷物	穀物
谷皮	穀皮
谷神	穀神
谷谷	穀穀
谷粒	穀粒
谷舱	穀艙
谷苗	穀苗
谷草	穀草
谷贱伤农	穀賤傷農
谷道	穀道
谷雨	穀雨
谷类	穀類
谷风	穀風
积极参与	積极參与
积极参加	積极參加
积谷防饥	積穀防饑
空口无凭	空口無憑
空蒙	空濛
窗台	窗台
窗帘	窗帘
窗明几净	窗明几淨
窗台	窗檯
窝里	窩裡
穷发	窮髮
立于	立於
站台	站台
竟于	竟於
竹林之游	竹林之遊
笆斗	笆斗
笑里藏刀	笑裡藏刀
第一卷	第一卷
第四台	第四台
等同于	等同於
等于	等於
筋斗	筋斗
答卷	答卷
答复	答複
答复	答覆
筵几	筵几
箕斗	箕斗
算历	算曆
签着	簽著
粗制	粗製
粗卤	粗鹵
精干	精幹
精于	精於
精明强干	精明強幹
精致	精緻
精制	精製
精辟	精辟
精通于	精通於
精采	精采
糊里糊涂	糊裡糊塗
团子	糰子
系着	系著
系里	系裡
纪历	紀曆
红绳系足	紅繩繫足
红发	紅髮
纡回	紆迴
纳采	納采
素食面	素食麵
素发	素髮
素面	素麵
紫微斗数	紫微斗數
紫姜	紫薑
细致	細緻
终于	終於
组里	組裡
结伴同游	結伴同遊
结发	結髮
绝对参照	絕對參照
绝缘台	絕緣台
络绎于途	絡繹於途
丝来线去	絲來線去
丝布	絲布
丝板	絲板
丝瓜布	絲瓜布
丝绒布	絲絨布
丝线	絲線
丝织厂	絲織廠
丝虫	絲蟲
綑吊	綑吊
经卷	經卷
维系	維繫
绾发	綰髮
网里	網裡
紧绷	緊繃
紧绷着	緊繃著
编制	編製
编发	編髮
缓冲	緩衝
致密	緻密
萦回	縈迴
县里	縣裡
县志	縣誌
缝里	縫裡
缝制	縫製
纤夫	縴夫
纤手	縴手
繁复	繁複
绷住	繃住
绷子	繃子
绷带	繃帶
绷紧	繃緊
绷脸	繃臉
绷着	繃著
绷着脸	繃著臉
绷着脸儿	繃著臉兒
绷开	繃開
绘制	繪製
系上	繫上
系世	繫世
系到	繫到
系囚	繫囚
系心	繫心
系念	繫念
系怀	繫懷
系恋	繫戀
系数	繫數
系于	繫於
系系	繫系
系结	繫結
系紧	繫緊
系绳	繫繩
系累	繫纍
系着	繫著
系辞	繫辭
系风捕影	繫風捕影
缴卷	繳卷
累囚	纍囚
累累	纍纍
坛子	罈子
坛坛罐罐	罈罈罐罐
置于	置於
骂着	罵著
羁系	羈繫
美制	美製
美发	美髮
羞于	羞於
习于	習於
翱游	翱遊
翻来复去	翻來覆去
翻天复地	翻天覆地
翻复	翻覆
翻云复雨	翻雲覆雨
老么	老么
老台	老台
老于世故	老於世故
老姜	老薑
老板	老闆
考卷	考卷
而于	而於
耕获	耕穫
耽于	耽於
耿耿于怀	耿耿於懷
聊斋志异	聊齋誌異
圣火台	聖火台
联系	聯係
联于	聯於
联系	聯繫
听凭	聽憑
肉丝面	肉絲麵
肉羹面	肉羹麵
肉松	肉鬆
肚里	肚裏
肚里	肚裡
肢体	肢体
胃里	胃裡
背向着	背向著
背地里	背地裡
胡里胡涂	胡裡胡塗
能干	能幹
脉冲	脈衝
修脯	脩脯
脱发	脫髮
腊味	腊味
腊笔	腊筆
腊肉	腊肉
脑子里	腦子裡
腰里	腰裡
脚注	腳註
胶卷	膠卷
膨松	膨鬆
臣服于	臣服於
卧游	臥遊
自制	自製
自觉自愿	自覺自愿
自夸	自誇
至于	至於
致力于	致力於
臻于完善	臻於完善
舂谷	舂穀
兴致	興緻
兴高采烈	興高采烈
旧历	舊曆
旧游	舊遊
舒卷	舒卷
舞台	舞台
航海历	航海曆
船台	船台
船只	船隻
舰只	艦隻
芬郁	芬郁
花卷	花卷
花盆里	花盆裡
花采	花采
苑里	苑裡
若干	若干
若干	若幹
若于	若於
苦干	苦幹
苦于	苦於
苦里	苦裏
苦卤	苦鹵
范仲淹	范仲淹
范蠡	范蠡
范阳	范陽
茅台	茅台
茶几	茶几
草丛里	草叢裡
庄里	莊裡
茎干	莖幹
菌丝体	菌絲体
菌丝体	菌絲體
华里	華裡
华发	華髮
万卷	萬卷
万历	萬曆
万只	萬隻
落于	落於
落发	落髮
着儿	著兒
着手于	著手於
着书立说	著書立說
着色软体	著色軟體
着迷于	著迷於
着重指出	著重指出
着录	著錄
着录规则	著錄規則
蓄发	蓄髮
蓄须	蓄鬚
盖于	蓋於
蓬发	蓬髮
蓬松	蓬鬆
莲台	蓮台
姜末	薑末
姜母	薑母
姜汁	薑汁
姜片	薑片
姜糖	薑糖
姜丝	薑絲
姜茶	薑茶
姜饼	薑餅
薙发	薙髮
借以	藉以
借助	藉助
借口	藉口
借故	藉故
借机	藉機
借此	藉此
借由	藉由
借端	藉端
借着	藉著
借借	藉藉
借词	藉詞
借资	藉資
借酒浇愁	藉酒澆愁
藏匿于	藏匿於
藤制	藤製
蕴含着	蘊含著
蕴涵着	蘊涵著
蕴借	蘊藉
萝卜	蘿蔔
虎须	虎鬚
处于	處於
虚夸	虛誇
号志	號誌
蜂后	蜂后
蜜里调油	蜜裡調油
蠁干	蠁幹
蛮干	蠻幹
行事历	行事曆
胡同	衚衕
冲上	衝上
冲下	衝下
冲来	衝來
冲倒	衝倒
冲冠	衝冠
冲出	衝出
冲到	衝到
冲刺	衝刺
冲克	衝剋
冲力	衝力
冲劲	衝勁
冲动	衝動
冲去	衝去
冲口	衝口
冲垮	衝垮
冲堂	衝堂
冲压	衝壓
冲天	衝天
冲掉	衝掉
冲撞	衝撞
冲击	衝擊
冲散	衝散
冲决	衝決
冲浪	衝浪
冲激	衝激
冲破	衝破
冲程	衝程
冲突	衝突
冲线	衝線
冲着	衝著
冲冲	衝衝
冲要	衝要
冲起	衝起
冲进	衝進
冲过	衝過
冲锋	衝鋒
表里	表裡
袋里	袋裡
袖里	袖裡
被里	被裡
被复	被複
被复	被覆
被复着	被覆著
被发	被髮
裁并	裁併
裁制	裁製
里面	裏面
补注	補註
里人	裡人
里加	裡加
里外	裡外
里子	裡子
里屋	裡屋
里层	裡層
里布	裡布
里带	裡帶
里弦	裡弦
里应外合	裡應外合
里拉	裡拉
里斯	裡斯
里海	裡海
里脊	裡脊
里衣	裡衣
里里	裡裡
里通外国	裡通外國
里通外敌	裡通外敵
里边	裡邊
里间	裡間
里面	裡面
里头	裡頭
制件	製件
制作	製作
制做	製做
制备	製備
制冰	製冰
制冷	製冷
制剂	製劑
制品	製品
制图	製圖
制成	製成
制法	製法
制为	製為
制片	製片
制版	製版
制程	製程
制糖	製糖
制纸	製紙
制药	製藥
制表	製表
制裁	製裁
制造	製造
制革	製革
制鞋	製鞋
制盐	製鹽
复仞年如	複仞年如
复以百万	複以百萬
复位	複位
复信	複信
复分数	複分數
复列	複列
复利	複利
复印	複印
复原	複原
复句	複句
复合	複合
复名	複名
复员	複員
复壁	複壁
复壮	複壯
复姓	複姓
复字键	複字鍵
复审	複審
复写	複寫
复式	複式
复复	複復
复数	複數
复本	複本
复查	複查
复核	複核
复检	複檢
复次	複次
复比	複比
复决	複決
复活	複活
复测	複測
复亩珍	複畝珍
复发	複發
复目	複目
复眼	複眼
复种	複種
复线	複線
复习	複習
复兴社	複興社
复旧	複舊
复色	複色
复叶	複葉
复盖	複蓋
复苏	複蘇
复制	複製
复诊	複診
复评	複評
复词	複詞
复试	複試
复课	複課
复议	複議
复变函数	複變函數
复赛	複賽
复述	複述
复选	複選
复钱	複錢
复阅	複閱
复杂	複雜
复电	複電
复音	複音
复韵	複韻
衬里	襯裡
西岳	西嶽
西征	西征
西历	西曆
西游	西遊
要冲	要衝
要么	要麼
复上	覆上
复亡	覆亡
复住	覆住
复信	覆信
复冒	覆冒
复判	覆判
复命	覆命
复在	覆在
复审	覆審
复写	覆寫
复巢	覆巢
复成	覆成
复败	覆敗
复文	覆文
复校	覆校
复核	覆核
复水难收	覆水難收
复没	覆沒
复灭	覆滅
复叠	覆疊
复盆	覆盆
复舟	覆舟
复着	覆著
复盖	覆蓋
复盖着	覆蓋著
复试	覆試
复诵	覆誦
复议	覆議
复车	覆車
复载	覆載
复辙	覆轍
复述	覆述
复选	覆選
复电	覆電
复鼎金	覆鼎金
见于	見於
见复	見覆
亲征	親征
观台	觀台
观星台	觀星台
观望台	觀望台
观众台	觀眾台
观象台	觀象台
角落里	角落裡
觔斗	觔斗
触须	觸鬚
订于	訂於
订制	訂製
访台	訪台
设台	設台
设于	設於
诉说着	訴說著
注上	註上
注册	註冊
注失	註失
注定	註定
注明	註明
注标	註標
注生娘娘	註生娘娘
注疏	註疏
注脚	註腳
注解	註解
注记	註記
注译	註譯
注释	註釋
注销	註銷
评注	評註
词汇	詞彙
词采	詞采
试卷	試卷
试制	試製
诗卷	詩卷
话里有话	話裡有話
该于	該於
详注	詳註
夸下海口	誇下海口
夸了	誇了
夸来夸去	誇來誇去
夸别	誇別
夸功	誇功
夸口	誇口
夸嘴	誇嘴
夸大	誇大
夸张	誇張
夸得	誇得
夸成	誇成
夸奖	誇獎
夸示	誇示
夸耀	誇耀
夸着	誇著
夸夸	誇誇
夸诞	誇誕
夸讚	誇讚
夸起	誇起
夸过	誇過
夸饰	誇飾
志哀	誌哀
志喜	誌喜
志庆	誌慶
诱奸	誘姦
语云	語云
语汇	語彙
诬蔑	誣衊
说着	說著
课征	課征
调幅台	調幅台
调理台	調理台
调制	調製
调频台	調頻台
请参阅	請參閱
讲台	講台
谢绝参观	謝絕參觀
证于	證於
译注	譯註
护发	護髮
雠正	讎正
雠隙	讎隙
豆腐干	豆腐干
竖着	豎著
丰台	豐台
丰富多采	豐富多采
丰滨	豐濱
丰滨乡	豐濱鄉
丰采	豐采
象征着	象徵著
贵干	貴幹
贾后	賈后
赈饥	賑饑
赐复	賜覆
贤后	賢后
质朴	質朴
赌台	賭檯
赖于	賴於
购并	購併
赤绳系足	赤繩繫足
赤松	赤鬆
赴台	赴台
起吊	起吊
起因于	起因於
起于	起於
起复	起複
超级杯	超級盃
赶制	趕製
趋于	趨於
跟斗	跟斗
跳伞台	跳傘台
跳台	跳台
跳水台	跳水台
跳表	跳錶
蹈借	蹈藉
踬仆	躓仆
躯干	軀幹
车库里	車庫裡
车站里	車站裡
车里	車裡
载于	載於
轻于	輕於
轻松	輕鬆
轮奸	輪姦
轮回	輪迴
转台	轉台
转播台	轉播台
转台	轉檯
辛丑	辛丑
辟易	辟易
辟邪	辟邪
办伙	辦伙
办公台	辦公檯
辞汇	辭彙
农历	農曆
迂回	迂迴
近似于	近似於
近于	近於
近日里	近日裡
返台	返台
迥然回异	迥然迴異
迫于	迫於
回光返照	迴光返照
回向	迴向
回圈	迴圈
回廊	迴廊
回形夹	迴形夾
回文	迴文
回旋	迴旋
回流	迴流
回环	迴環
回盪	迴盪
回纹针	迴紋針
回绕	迴繞
回翔	迴翔
回肠	迴腸
回荡	迴蕩
回诵	迴誦
回路	迴路
回转	迴轉
回递性	迴遞性
回避	迴避
回銮	迴鑾
回音	迴音
回响	迴響
回风	迴風
回首	迴首
迷蒙	迷濛
退伙	退伙
逍遥游	逍遙遊
这么着	這么著
这台	這台
这里	這裏
这里	這裡
这只	這隻
这么	這麼
这么着	這麼著
通奸	通姦
通心面	通心麵
速食面	速食麵
连台好戏	連台好戲
连于	連於
连系	連繫
周游	週遊
游了	遊了
游人	遊人
游仙	遊仙
游伴	遊伴
游侠	遊俠
游冶	遊冶
游动	遊動
游园	遊園
游子	遊子
游学	遊學
游客	遊客
游宦	遊宦
游山玩水	遊山玩水
游必有方	遊必有方
游憩	遊憩
游戏	遊戲
游手好闲	遊手好閑
游手好閒	遊手好閒
游击	遊擊
游方	遊方
游星	遊星
游乐	遊樂
游标卡尺	遊標卡尺
游历	遊歷
游民	遊民
游河	遊河
游牧	遊牧
游猎	遊獵
游玩	遊玩
游盪	遊盪
游目骋怀	遊目騁懷
游程	遊程
游丝	遊絲
游兴	遊興
游船	遊船
游艇	遊艇
游荡	遊蕩
游艺	遊藝
游行	遊行
游街	遊街
游览	遊覽
游记	遊記
游说	遊說
游资	遊資
游走	遊走
游踪	遊蹤
游逛	遊逛
游错	遊錯
游离	遊離
游骑兵	遊騎兵
游魂	遊魂
遍布	遍佈
遍于	遍於
过于	過於
递回	遞迴
远征	遠征
远于	遠於
远游	遠遊
遨游	遨遊
适于	適於
适才	適纔
遮复	遮覆
迁台	遷台
迁怒于	遷怒於
选台	選台
还政于民	還政於民
还于	還於
还冲	還衝
邋里邋遢	邋裡邋遢
邢台	邢台
那台	那台
那里	那裏
那里	那裡
那只	那隻
那么	那麼
那么着	那麼著
邪辟	邪辟
郁烈	郁烈
郁穆	郁穆
郁郁	郁郁
郁闭	郁閉
郁馥	郁馥
郊游	郊遊
乡愿	鄉愿
乡里	鄉裡
邻里	鄰裡
配合着	配合著
配制	配製
酒杯	酒盃
酒坛	酒罈
酥松	酥鬆
醉心于	醉心於
醋坛	醋罈
酝借	醞藉
酝酿着	醞釀著
医药	醫葯
醲郁	醲郁
酿制	釀製
采地	采地
采女	采女
采声	采聲
采色	采色
采薇	采薇
采薪之忧	采薪之憂
采兰赠药	采蘭贈藥
采邑	采邑
采采	采采
采风	采風
里程表	里程錶
重折	重摺
重于	重於
重制	重製
重复	重複
重复	重覆
重游	重遊
野台	野台
野游	野遊
金斗	金斗
金装玉里	金裝玉裡
金表	金錶
金发	金髮
钓鱼台	釣魚台
铉台	鉉台
银朱	銀硃
银发	銀髮
铜制	銅製
铝制	鋁製
钢制	鋼製
录着	錄著
录制	錄製
表带	錶帶
表店	錶店
表厂	錶廠
表壳	錶殼
表链	錶鏈
表面	錶面
锅台	鍋台
锻鍊出	鍛鍊出
锻鍊身体	鍛鍊身体
键台	鍵台
钟子期	鍾子期
钟山	鍾山
钟情	鍾情
钟爱	鍾愛
钟县	鍾縣
钟表	鍾錶
钟离	鍾離
钟灵毓秀	鍾靈毓秀
钟馗	鍾馗
镜台	鏡台
锈病	鏽病
锈菌	鏽菌
锈蚀	鏽蝕
钟表	鐘錶
铁锈	鐵鏽
鑑于	鑑於
鉴于	鑒於
钻台	鑽台
长吁短叹	長吁短嘆
长吁短歎	長吁短歎
长征	長征
长于	長於
长发	長髮
长须鲸	長鬚鯨
门帘	門帘
门斗	門斗
门里	門裡
开伙	開伙
开列于后	開列於後
开卷	開卷
开诚布公	開誠佈公
开采	開采
閒情逸致	閒情逸緻
閒游	閒遊
间不容发	間不容髮
闵采尔	閔采爾
闽台	閩台
阅兵台	閱兵台
阅卷	閱卷
暗伦	闇倫
暗冥	闇冥
暗劣	闇劣
暗弱	闇弱
暗然	闇然
阑干	闌干
关系	關係
关系着	關係著
关于	關於
防御	防禦
防锈	防鏽
防台	防颱
阿斗	阿斗
阿里	阿裡
附注	附註
降于	降於
限于	限於
除旧布新	除舊佈新
阴干	陰干
阴历	陰曆
阴郁	陰郁
陷于	陷於
陆征祥	陸征祥
陆游	陸遊
阳台	陽台
阳春面	陽春麵
阳历	陽曆
只字	隻字
只影	隻影
只手遮天	隻手遮天
只眼	隻眼
只言片语	隻言片語
只身	隻身
雅致	雅緻
集于一身	集於一身
集游法	集遊法
雇佣	雇佣
雇于	雇於
双折	雙摺
杂志	雜誌
鸡奸	雞姦
鸡丝	雞絲
鸡丝面	雞絲麵
鸡腿面	雞腿麵
鸡只	雞隻
难容于	難容於
难舍	難捨
难于	難於
雪里	雪裡
云游	雲遊
云须	雲鬚
电台	電台
电子表	電子錶
电冲	電衝
电复	電覆
电视台	電視台
电表	電錶
震于	震於
雾台	霧台
雾里	霧裡
露台	露台
灵台	靈台
灵修	靈脩
青瓦台	青瓦台
青霉	青黴
非于	非於
面朝着	面朝著
面临着	面臨著
靶台	靶台
鞋里	鞋裡
鞣制	鞣製
鞭辟入里	鞭辟入裡
韩国制	韓國製
韩制	韓製
音乐台	音樂台
颂系	頌繫
预制	預製
颁布	頒佈
头里	頭裡
头发	頭髮
颊须	頰鬚
颠仆	顛仆
颠复	顛複
颠复	顛覆
类似于	類似於
显着标志	顯著標志
风土志	風土誌
风斗	風斗
风物志	風物誌
风里	風裡
风采	風采
台风	颱風
刮了	颳了
刮倒	颳倒
刮去	颳去
刮得	颳得
刮着	颳著
刮走	颳走
刮起	颳起
刮风	颳風
飘游	飄遊
饭团	飯糰
饼干	餅干
馄饨面	餛飩麵
饥不择食	饑不擇食
饥寒	饑寒
饥民	饑民
饥渴	饑渴
饥溺	饑溺
饥荒	饑荒
饥饱	饑飽
饥饿	饑餓
饥馑	饑饉
首台	首台
首当其冲	首當其衝
香郁	香郁
馥郁	馥郁
马里	馬裡
马表	馬錶
腾冲	騰衝
骨子里	骨子裡
骨干	骨幹
骨灰坛	骨灰罈
肮脏	骯髒
脏乱	髒亂
脏了	髒了
脏兮兮	髒兮兮
脏字	髒字
脏得	髒得
脏东西	髒東西
脏水	髒水
脏的	髒的
脏话	髒話
脏钱	髒錢
高台	高台
高干	高幹
高于	高於
髭须	髭鬚
发型	髮型
发夹	髮夾
发妻	髮妻
发姐	髮姐
发带	髮帶
发廊	髮廊
发式	髮式
发指	髮指
发捲	髮捲
发根	髮根
发毛	髮毛
发油	髮油
发状	髮狀
发短心长	髮短心長
发端	髮端
发结	髮結
发丝	髮絲
发网	髮網
发肤	髮膚
发胶	髮膠
发菜	髮菜
发蜡	髮蠟
发辫	髮辮
发针	髮針
发长	髮長
发际	髮際
发雕	髮雕
发霜	髮霜
发髻	髮髻
发鬓	髮鬢
鬅松	鬅鬆
松了	鬆了
松些	鬆些
松劲	鬆勁
松动	鬆動
松口	鬆口
松土	鬆土
松弛	鬆弛
松快	鬆快
松懈	鬆懈
松手	鬆手
松掉	鬆掉
松散	鬆散
松林	鬆林
松柔	鬆柔
松毛虫	鬆毛蟲
松浮	鬆浮
松涛	鬆濤
松科	鬆科
松节油	鬆節油
松绑	鬆綁
松紧	鬆緊
松缓	鬆緩
松脆	鬆脆
松脱	鬆脫
松起	鬆起
松软	鬆軟
松通	鬆通
松开	鬆開
松饼	鬆餅
松松	鬆鬆
鬈发	鬈髮
胡子	鬍子
胡梢	鬍梢
胡渣	鬍渣
胡髭	鬍髭
胡须	鬍鬚
须根	鬚根
须毛	鬚毛
须生	鬚生
须眉	鬚眉
须发	鬚髮
须须	鬚鬚
鬓发	鬢髮
斗着	鬥著
闹着玩儿	鬧著玩儿
闹着玩儿	鬧著玩兒
郁郁	鬱郁
魂牵梦系	魂牽夢繫
鱼松	魚鬆
鲸须	鯨鬚
鸿篇巨制	鴻篇巨製
鹤发	鶴髮
卤化	鹵化
卤味	鹵味
卤族	鹵族
卤水	鹵水
卤汁	鹵汁
卤簿	鹵簿
卤素	鹵素
卤莽	鹵莽
卤钝	鹵鈍
咸味	鹹味
咸土	鹹土
咸度	鹹度
咸得	鹹得
咸水	鹹水
咸海	鹹海
咸淡	鹹淡
咸湖	鹹湖
咸汤	鹹湯
咸的	鹹的
咸肉	鹹肉
咸菜	鹹菜
咸蛋	鹹蛋
咸猪肉	鹹豬肉
咸类	鹹類
咸鱼	鹹魚
咸鸭蛋	鹹鴨蛋
咸卤	鹹鹵
咸咸	鹹鹹
盐卤	鹽鹵
面价	麵價
面包	麵包
面团	麵團
面店	麵店
面厂	麵廠
面摊	麵攤
面杖	麵杖
面条	麵條
面灰	麵灰
面皮	麵皮
面筋	麵筋
面粉	麵粉
面糊	麵糊
面线	麵線
面茶	麵茶
面食	麵食
面饺	麵餃
面饼	麵餅
麻酱面	麻醬麵
黄卷	黃卷
黄历	黃曆
黄发	黃髮
黑发	黑髮
黑松	黑鬆
霉毒	黴毒
霉素	黴素
霉菌	黴菌
鼓台	鼓台
鼓里	鼓裡
冬冬	鼕鼕
龙卷	龍卷
龙钟	龍鍾
龙须	龍鬚
内存	記憶體
默认	預設
缺省	預設
串行	串列
以太网	乙太網
位图	點陣圖
例程	常式
信道	通道
光标	游標
光盘	光碟
光驱	光碟機
全角	全形
共享	共用
兼容	相容
前缀	首碼
后缀	尾碼
加载	載入
半角	半形
变量	變數
噪声	雜訊
因子	因數
在线	線上
脱机	離線
域名	功能變數名稱
声卡	音效卡
字号	字型大小
字库	字型檔
字段	欄位
字符	字元
存盘	存檔
寻址	定址
尾注	章節附註
异步	非同步
总线	匯流排
括号	括弧
接口	介面
控件	控制項
权限	許可權
盘片	碟片
硅片	矽片
硅谷	矽谷
硬盘	硬碟
磁盘	磁碟
磁道	磁軌
程控	程式控制
端口	埠
算子	運算元
算法	演算法
演算法	演算法
芯片	晶片
芯片	晶元
词组	片語
译码	解碼
软驱	軟碟機
闪存	快閃記憶體
鼠标	滑鼠
进制	進位
交互式	互動式
仿真	模擬
优先级	優先順序
传感	感測
便携式	攜帶型
信息论	資訊理論
循环	迴圈
写保护	防寫
分布式	分散式
分辨率	解析度
服务器	伺服器
局域网	區域網
上载	上傳
计算机	電腦
扫瞄仪	掃瞄器
宽带	寬頻
窗口	視窗
数据库	資料庫
公历	西曆
奶酪	乳酪
巨商	鉅賈
手电	手電筒
万历	萬曆
永历	永曆
词汇	辭彙
保安	保全
习用	慣用
元音	母音
任意球	自由球
头球	頭槌
入球	進球
粒入球	顆進球
打门	射門
火锅盖帽	蓋火鍋
打印机	印表機
打印機	印表機
字节	位元組
字節	位元組
打印	列印
打印	列印
硬件	硬體
硬件	硬體
二极管	二極體
二極管	二極體
三极管	三極體
三極管	三極體
数码	數位
數碼	數位
软件	軟體
軟件	軟體
网络	網路
網絡	網路
人工智能	人工智慧
航天飞机	太空梭
穿梭機	太空梭
因特网	網際網路
互聯網	網際網路
机器人	機器人
機械人	機器人
移动电话	行動電話
流動電話	行動電話
调制解调器	數據機
調制解調器	數據機
短信	簡訊
短訊	簡訊
乌兹别克斯坦	烏茲別克
乍得	查德
乍得	查德
也门	葉門
也門	葉門
伯利兹	貝里斯
伯利茲	貝里斯
佛得角	維德角
佛得角	維德角
克罗地亚	克羅埃西亞
克羅地亞	克羅埃西亞
冈比亚	甘比亞
岡比亞	甘比亞
几内亚比绍	幾內亞比索
幾內亞比紹	幾內亞比索
列支敦士登	列支敦斯登
列支敦士登	列支敦斯登
利比里亚	賴比瑞亞
利比里亞	賴比瑞亞
加纳	迦納
加納	迦納
加蓬	加彭
加蓬	加彭
博茨瓦纳	波札那
博茨瓦納	波札那
卡塔尔	卡達
卡塔爾	卡達
卢旺达	盧安達
盧旺達	盧安達
危地马拉	瓜地馬拉
危地馬拉	瓜地馬拉
厄瓜多尔	厄瓜多
厄瓜多爾	厄瓜多
厄立特里亚	厄利垂亞
厄立特里亞	厄利垂亞
吉布提	吉布地
吉布堤	吉布地
哈萨克斯坦	哈薩克
哥斯达黎加	哥斯大黎加
哥斯達黎加	哥斯大黎加
图瓦卢	吐瓦魯
圖瓦盧	吐瓦魯
土库曼斯坦	土庫曼
圣卢西亚	聖露西亞
聖盧西亞	聖露西亞
圣基茨和尼维斯	聖克里斯多福及尼維斯
聖吉斯納域斯	聖克里斯多福及尼維斯
圣文森特和格林纳丁斯	聖文森及格瑞那丁
聖文森特和格林納丁斯	聖文森及格瑞那丁
圣马力诺	聖馬利諾
聖馬力諾	聖馬利諾
圭亚那	蓋亞那
圭亞那	蓋亞那
坦桑尼亚	坦尚尼亞
坦桑尼亞	坦尚尼亞
埃塞俄比亚	衣索比亞
埃塞俄比亞	衣索比亞
基里巴斯	吉里巴斯
基里巴斯	吉里巴斯
塔吉克斯坦	塔吉克
塞拉利昂	獅子山
塞拉利昂	獅子山
塞浦路斯	塞普勒斯
塞浦路斯	塞普勒斯
塞舌尔	塞席爾
塞舌爾	塞席爾
多米尼加	多明尼加
多明尼加共和國	多明尼加
多米尼加联邦	多米尼克
多明尼加聯邦	多米尼克
安提瓜和巴布达	安地卡及巴布達
安提瓜和巴布達	安地卡及巴布達
尼日利亚	奈及利亞
尼日利亞	奈及利亞
尼日尔	尼日
尼日爾	尼日
巴巴多斯	巴貝多
巴巴多斯	巴貝多
巴布亚新几内亚	巴布亞紐幾內亞
巴布亞新畿內亞	巴布亞紐幾內亞
布基纳法索	布吉納法索
布基納法索	布吉納法索
布隆迪	蒲隆地
布隆迪	蒲隆地
希腊	希臘
帕劳	帛琉
意大利	義大利
意大利	義大利
所罗门群岛	索羅門群島
所羅門群島	索羅門群島
文莱	汶萊
斯威士兰	史瓦濟蘭
斯威士蘭	史瓦濟蘭
斯洛文尼亚	斯洛維尼亞
斯洛文尼亞	斯洛維尼亞
新西兰	紐西蘭
新西蘭	紐西蘭
格林纳达	格瑞那達
格林納達	格瑞那達
格鲁吉亚	喬治亞
格魯吉亞	喬治亞
梵蒂冈	教廷
梵蒂岡	教廷
毛里塔尼亚	茅利塔尼亞
毛里塔尼亞	茅利塔尼亞
毛里求斯	模里西斯
毛里裘斯	模里西斯
沙特阿拉伯	沙烏地阿拉伯
沙地阿拉伯	沙烏地阿拉伯
波斯尼亚和黑塞哥维那	波士尼亞赫塞哥維納
波斯尼亞黑塞哥維那	波士尼亞赫塞哥維納
津巴布韦	辛巴威
津巴布韋	辛巴威
洪都拉斯	宏都拉斯
洪都拉斯	宏都拉斯
特立尼达和托巴哥	千里達托貝哥
特立尼達和多巴哥	千里達托貝哥
瑙鲁	諾魯
瑙魯	諾魯
瓦努阿图	萬那杜
瓦努阿圖	萬那杜
溫納圖萬	那杜
科摩罗	葛摩
科摩羅	葛摩
科特迪瓦	象牙海岸
突尼斯	突尼西亞
索马里	索馬利亞
索馬里	索馬利亞
老挝	寮國
老撾	寮國
肯尼亚	肯亞
肯雅	肯亞
苏里南	蘇利南
莫桑比克	莫三比克
莱索托	賴索托
萊索托	賴索托
贝宁	貝南
貝寧	貝南
赞比亚	尚比亞
贊比亞	尚比亞
阿塞拜疆	亞塞拜然
阿塞拜疆	亞塞拜然
阿拉伯联合酋长国	阿拉伯聯合大公國
阿拉伯聯合酋長國	阿拉伯聯合大公國
韩国	南韓
马尔代夫	馬爾地夫
馬爾代夫	馬爾地夫
马耳他	馬爾他
马里	馬利
馬里	馬利
方便面	速食麵
快速面	速食麵
即食麵	速食麵
薯仔	土豆
蹦极跳	笨豬跳
绑紧跳	笨豬跳
冷菜	冷盤
凉菜	冷盤
的士	計程車
出租车	計程車
巴士	公車
公共汽车	公車
台球	撞球
桌球	撞球
雪糕	冰淇淋
卫生	衛生
衞生	衛生
平治	賓士
奔驰	賓士
積架	捷豹
福士	福斯
雪铁龙	雪鐵龍
马自达	馬自達
萬事得	馬自達
布什	布希
布殊	布希
克林顿	柯林頓
克林頓	柯林頓
萨达姆	海珊
薩達姆	海珊
凡高	梵谷
狄安娜	黛安娜
戴安娜	黛安娜
赫拉	希拉
操作系统	作業系統
信息	資訊
面向对象	物件導向
构造函数	建構式
笔记本电脑	筆記型電腦
青霉素	盤尼西林
塞尔维亚和黑山	塞爾維亞與蒙特內格羅
英联邦	大英國協
英聯邦	大英國協
下面	下面
残余	殘餘
卢塞恩	琉森
